############################
###          B             #
### ####    #############  #
### ####                   #
### ####    #############  #
###         ##          #  #
### ######  ##          #  #
### ####### ##          ####
###         ##
#######A######